1111111111111111111111111111111111
1P000000C00000C0000000000CC00000E1
1010C10100100000101001000000010101
101001001010101000100100P000010101
100000C000000000C000000E0000C00001
1000000P10000000000000C00000000001
1000000010100000E0000000C000010001
10C0000010010000P00C00000010000001
1000000000001000000000000100000001
10000000C000000000P000000100000001
1000000000000111000000000000000001
1P0000C0000000000000100001000000E1
1111111111111111111111111111111111