11111111111111111111
1C1CC00E0CCCC0000P01
11C1C0000C11C00E1111
1CC111000C1CC0000001
1CCCC0000C1CC0000001
10000C11C0100CCCC001
10000C0CC0100C11C001
10001CCCC0100C11C001
1E001CCCC0111CCCC001
1000P00000100000P001
10011111111000000001
100C000C001P00000001
10000000001111100001
1111PC0000000C000001
1C00000C000000000PE1
11111111111111111111