1111111111
10C0010001111
10P00E0C000E1
100C00CCC0001
1ECCC00CC1111
1111111111