1111111111111
10010000000C1
1000011111000
1P0011E000000
1111111101111